9391939493919393919394939202039091949194
4141414141414141414141414205024041414141
5151515151515151515151515205045051515151
6161614451515151515151515203035051515151
0105076044515151515151515341415451515151
0407070560616161616161616144436161616161
0603040000030102050404070450520104050000
0003040303020305010007070750520303000404
0702040500070401070003040450520302050401
1112000304070607050102404154534141414141
2122000407030204030740545151515151515151

image image:outdoors
neighbors map:3 map:5 map:2 map:4
sprite @10,6 sprite:hero (u32)0
