2121133204020504000002000100070703060530
2113320300000100020402020503010507010703
2122000503020701030507050204040307020202
3132070004101204020003340240420307000204
0301000210242312020000054054534206070003
0404040030141332000500056044436202010602
0607040007303205040505070460620201034041
0001070700000706020102040305010702015051
0700030004000204070407030507030002405451
1112000604020407050102060240414141545151
2122000407030204030740414154515151515151

image image:outdoors
neighbors map:3 map:5 map:2 map:4
sprite @9,4 sprite:hero (u32)0
