2121133204020504000002000100070703060530
2113320300000100020402020004030407010703
2122000503020701030507010040420504020202
3132070004101204020003334054534202000204
0301000210242312020000006044436202070003
0404040030141332000500070760620201020602
0607070307303202050400040605050203074041
0001070701030702020007070703020703075051
0700000406030205040002030407030002405451
1112000604020407050102060240414141545151
2122000407030204030740414154515151515151

image image:outdoors
neighbors map:3 map:5 map:2 map:4
sprite @9,4 sprite:hero (u32)0
sprite @12,6 sprite:wishbone (u8:flag)wishbone (u8:prize)none (u16)0
sprite @4,6 sprite:heart (u8:flag)zero (u8:prize)heart (u16)0
