2411162413142531313131313131313131312624
2323162121212200000000000000000000002016
2324241314132200000000000000000000002014
3131313131313200000000000000000000002021
0000030000000000000000000000000000002023
1512000000000000000000000000000000002013
1122000000000000000000000000000000002021
1135151515151515151200000000000000002013
2323232411211325313200000000000000002024
1613141413111322000000000000000000002024
2411142413231322001015151515151515153621

image image:castle
neighbors map:11 0x0000 0x0000 map:8
sprite @16,2 sprite:firepot sprite:fireball (u8:flag)one (u8)0
spawn sprite:redbug 5 (u8:flag)spawn2 (u32)0
switchable @2,4 (u8:flag)spawn2 0
