2531313131313131313131313131313131313126
2200000000000000000000000000000000000020
2200000000000000000000000000000000000020
2200000000000000000000000000000000000020
2200000000000000000000000000000000000020
2200000000000000000000000000000000000020
2200000000000000000000000000000000000020
2200000000000000000000000000000000000020
2200000000000000000000000000000000000020
2200000000000000000000000000000000000020
3515151515151515120010151515151515151536

image image:castle
neighbors 0x0000 0x0000 0x0000 map:13
sprite @15,5 sprite:boss (u32)0
sprite @9,10 sprite:hero (u32)0
