2531313131313131313131313131313131313126
2200000000000000000000000000000000000020
2200333434000000000033000000000000000020
2200003400001012001012001012000000000020
2200003400003032003032003032000000000020
2200000000000000000000000000000000000020
2200000000000000000000000000000000000020
2200000000000000000000000000000000000020
2200000000000000000000000000000000000020
2200000000000000000000000000000000000020
3515151515151515120010151515151515151536

image image:castle
neighbors 0x0000 0x0000 0x0000 map:13
sprite @10,6 sprite:grandpa (u8)0 (u8:npcaction)victory (u16)0
sprite @3,6 sprite:hero (u32)0
