2121212121133131313131313114212121212121
2121211331320505020003060230142121212121
2121212203020000000000000300301421212121
2121133201000000000000000001013014212121
2121220002000000000000000000010120212121
2121220200000000000000000000000320212121
2121220301000000000000000000000030142121
2121231200000000000000000000000707202121
2121212201000000000000000000000007301421
2121212202000000000000000000000004073014
2121212203000000000000000000000000020220

image image:outdoors
neighbors 0x0000 0x0000 0x0000 map:1
