3131313131320000003031313131313131313131
2200000000000000000000000000000000000030
2200000000000000000000000000000000000000
2200000000000000000000000000000000000000
2200000000000000000000000000000000000010
2200000000000000000000003401333334343320
2200000000000000000000003300000000000030
2200000000000000000000003400000000000000
2200000000000000000000003300000000000000
2200000000000000000000003300000000000010
2210101212121212101010121200001012101220

image image:castle
neighbors 0x0000 map:9 map:6 map:1
lock @13,5 (u8:flag)lock1 0x80
sprite @3,7 sprite:firepot sprite:fireball (u8:flag)one (u8)0
sprite @4,3 sprite:redbug (u32)0
sprite @8,7 sprite:redbug (u32)0
