2121212121133131313131313114212121212121
2121211331320505020003060230142121212121
2121212203000002070500000304202121212121
2121212202050105040000000707202121212121
2121212311120204050500000710242121212121
2121212121223433341533343420212121212121
2121211331320000000704000130313131142121
2121212200010005070500000207020306202121
2121212203010403010704000000000007301421
2121212200000303030300000000000004073014
2121212206020702000402000000000000020220

image image:outdoors
neighbors 0x0000 0x0000 0x0000 map:1
lock @9,5 (u8:flag)lock2 0
