5151515151515151515151515151515151515151
5151515151515151515151515151515151515151
5151515151515151515151515151515151515151
5151436161616161616161616161616161616161
5151520000030407040001050201070301070202
5151520605010203000306030005040701060001
5151520607040401000702020007070102070200
5151520002010303070301050704010701010303
5151520203010003010102010103000006030701
5151534141414201070305000007101111111111
5151515151515210111111111111242121212121

image image:outdoors
neighbors 0x0000 map:start 0x0000 0x0000
sprite @11,7 sprite:redbug (u32)0
sprite @6,5 sprite:redbug (u32)0
