2121212121133131311421212121212121212121
2121211331320302063031313114212121212121
2121212204050400010702000230311421212121
2121133202000000000000000307003031313131
2113320007000000000000000000020100040201
2122010200000000000000000000000000000000
1332050000000000000000000000000000000000
2202000000000000000000000000000000000000
2204030000000000000000000002030004000100
2312050603050707000304010100101111111111
2123111111111111111111111111242121212121

image image:outdoors
neighbors 0x0000 map:start 0x0000 0x0000
