2121212121133131311421212121212121212121
2121211331320500023031313114212121212121
2121212204050402010201000530311421212121
2121133201000503020302000502003031313131
2113320502040400020700000601070100040102
2122030105010203000306030005040701060001
1332070507040401000702020007070102070200
2205000302010303070301050704010701010303
2205020201040300010102010103000006030701
2312030604010505070305000007101111111111
2123111111111111111111111111242121212121

image image:outdoors
neighbors 0x0000 map:start 0x0000 0x0000
