2122030000000000000050515151515151515151
2122030000000000000260445151515151515151
2122010000000000000201505151515151515151
2122020000000000000001505151515151515151
2122070000000000000007505151515151515151
2122000000000000000004505151515151515151
2122050103000000000704505151515151515151
2123111204000300000040545151515151515151
2121212311120703030350515151515151515151
2121212121231111124054515151515151515151
2121212121212121225051515151515151515151

image image:outdoors
neighbors 0x0000 0x0000 map:start 0x0000
