2122040300060304505151515151515151515151
2122020007030204505151514361616161616144
3132040605070740545151515204030100060450
0600030707050560445151515200040304000750
0702050304020503604451515204000404010350
1112050505050105035051515341420203070150
2122040102020102026061616161620700404154
2123111201030107020504020702070501606161
2121212311120202000601040204030207040305
2121212121231111111111120701010400060103
2121212121212121212121231111111111111111

image image:outdoors
neighbors map:10 map:7 map:start 0x0000
sprite @15,3 sprite:grandpa (u8)0 (u8:npcaction)wishbone (u16)0
sprite @16,3 sprite:grandma (u8)0 (u8:npcaction)heal (u16)0
sprite @4,7 sprite:slime (u32)0
