2122040300060304505151515151515151515151
2122020007030204505151436161616161616144
3132040605070740545151520504030100060450
0600030707050560445151520707040304000750
0702050304020503604451520504040504010350
1112050505050105035051534142030003070150
2122040102020102026061616162040300404154
2123111201030107020504020701040101606161
2121212311120202000601040204030207040305
2121212121231111111111120701010400060103
2121212121212121212121231111111111111111

image image:outdoors
neighbors map:10 map:7 map:start 0x0000
sprite @14,3 sprite:grandpa (u8)0 (u8:npcaction)wishbone (u16)0
sprite @16,3 sprite:grandma (u8)0 (u8:npcaction)heal (u16)0
sprite @4,7 sprite:slime (u32)0
