9191919191919191919191919191920607019091
4204030402010401030103101111120504021011
52030000050107040500043031142204050a2021
5201000000020400000000010430320310112421
5200000007070300020505070201030d20212121
6204000003040200030706020306000030313131
0703030700010001050702010103000101404141
0204030703050701020104000002040440545151
0607000005010700040701050304064054515151
4141414141414141414204030040415451515151
5151515151515151515207000250515151515151

image image:outdoors
neighbors map:start 0x0000 map:9 map:7
stompbox @17,2 (u8:flag)castle_exit 0
switchable @15,4 (u8:flag)castle_exit 0
spawn sprite:redbug 2 (u8:flag)backdoorbugs (u32)0
