3131313131313131142121212121212121212121
0707020307070107303131142121212121212121
0000000000000004010204303131313131311421
0000000000000000000000010502010300043031
0000000000000000000000000000000000054041
0403020000000000000000000000030401025051
4142070103040100000000000105004041415451
5153414141420701020204020140415451515151
5151515151534141414141414154515151515151
5151515151515151515151515151515151515151
5151515151515151515151515151515151515151

image image:outdoors
neighbors map:start 0x0000 0x0000 0x0000
