3131313131313131142121212121212121212121
0707020302040107303131142121212121212121
0000000004640204010204303131313131311421
0000000002630100000000010502010300043031
0000000003640000070100000501000000054041
0403020001630200026463646407070302055051
4142070102020500070600000102070700405451
5153414141420105020104000002040440545151
5151515151534200040707010606064054515151
5151515151515341414141414141415451515151
5151515151515151515151515151515151515151

image image:outdoors
neighbors map:start 0x0000 0x0000 0x0000
