1413242323232200000020231413161113132316
1613132531313203030330313131262416161611
1621232200000000000000000000202116211616
1613162200000043000054000000303131313131
2416112200000000000000000000000000000000
2424232200000000454600000000000000000000
1121142200000000555600000000000000000000
1614112200000000000000000000101515151515
2423112200000044000053000000201414161416
2113162200000000000000000000201613142121
2314133515120000001015151515362111111613

image image:castle
neighbors 0x0000 map:8 map:11 map:2
spawn sprite:bee 4 (u8:flag)spawn1 (u32)0
switchable @9,1 (u8:flag)spawn1 0
switchable @7,1 (u8:flag)spawn1 0
switchable @8,1 (u8:flag)spawn1 0
