5151515151515151515201040450515151515151
5143616161616161616201060350515151515151
5152020700070202070700040750515151515151
5152040507030100030704070150515151515151
5152070701404203030300000460616161616161
5152010500505202010403020410111111111111
5152070503505202040102040020211331313114
6162040000606201020400050320212204020120
0407020001070201010104000220212201040420
0107030400070704050405101124212200040420
1111111111111111111111242121212311111124

image image:outdoors
neighbors map:4 0x0000 map:5 0x0000
sprite @17,8 sprite:container (u8:flag)container2 (u8:prize)container (u8)0 (u8)0
sprite @3,4 sprite:sensei (u8)17 (u8:npcaction)sensei (u16)0
sprite @12,5 sprite:sensei (u8)18 (u8:npcaction)sensei (u16)0
