5151515151515151515201040450515151515151
5151515151515151515205060350515151515151
5151514361616161616204040750515151515151
5151515204040701020303070150515151515151
5151515202020203030300000150515151515151
5151515203070303010403020150515151515151
5151515203050107040102040750515151515151
6161616205020002020400010750515151515151
0405000004020601010104040450515151515151
0107030400070704050407020250515151515151
1111111111111111111111111250515151515151

image image:outdoors
neighbors map:4 0x0000 map:5 0x0000
