1614111123112122003031313131313131313126
2311132321131122000000000000000000000020
2321162411242135123334001015151515120020
3131261423241413220000002021111621220020
0000202414253131320010153623232321220020
0000201411220000000020161114232321223320
0000303131320010120030312624131421220020
1200000000000020220000002023141314220020
3515151515151536351512003031313131320020
1321141123162425313132000000000000000020
1621211316132322000000001015151515151536

image image:castle
neighbors map:6 0x0000 map:12 map:9
sprite @18,4 sprite:firepot sprite:fireball (u8:flag)one (u8)0
sprite @9,5 sprite:bonfire (u32)0
