2531313131313132000000002021231311212111
3200000000000000000000002024241321111611
0000000000000000000000002016161321211614
0000000000000000000000002013231413111416
1200000000000000000000002021132323161424
3515151515151515151515153623142124211123
3131313131313131313131313131313131312614
0000000000000000000000000000000000002024
0000000000000000000000000000000000002011
1200000000000000000000000000000000002023
3515151515151515151515151515120000002024

image image:castle
neighbors map:2 0x0000 map:8 map:5
sprite @11,4 sprite:firepot sprite:fireball (u8:flag)one (u8)0
