2231313131313132000000002024142311132314
3200000000000000000000002013231111242321
0000000000000000000000002023132413211114
0000000000000000000000002021142123112323
1200000000000000000000002014232421231321
2233343334333433343333333031313131313113
3200000000000000000000000000000000002024
0000000000000000000000000000000000002014
0000000000000000000000000000000000002024
1200000000000000000000000000000000002024
2212121210121212101210121210120000002023

image image:castle
neighbors map:2 0x0000 map:8 map:5
sprite @11,4 sprite:firepot sprite:fireball (u8:flag)one (u8)0
