2531313131313132000000003031313131313126
3200000000000000000000000000000000000020
0000000000000000000000000000000000000020
0000000000000000000000000000000000000020
1200000000000000000000000000000000000020
3515151515151515151515151515151515151536
3131313131313131313131313131313131312614
0404040404040404040404040404040404042024
0404040404040404040404040404040404042011
1204040404040404040404040404040400042023
3515151515151515151515151515120404042024

image image:castle
neighbors map:2 0x0000 map:8 map:5
sprite @18,4 sprite:firepot sprite:fireball (u8:flag)one (u8)0
spawn sprite:redbug 2 0 (u32)0
